##################################################
#                #                               #
#                #                               #
#                #                         1     #
#                #                               #
#       p        #                               #
#                #                               #
#                #                               #
#                #                               #
#                #                               #
#                #                               #
#                                                #
#                                                #
#                                                #
#                                                #
#                                                #
#                                                #
#                                                #
#                                                #
#                                                #
########        ##################################
#                                                #
#                                                #
#                                                #
#                                                #
#                                      g         #
#                                                #
#                                                #
#                                                #
##################################################
